+++++++++++++++++++++++++++++++++++++++++++++++++++++++++++++++++++++
+              +        +       +    +                   +          +
+              +        +       +    +                   +          +
+              +        +       +    +                   +          +
+              +        +       +    +                   +          +
+    +    ++++++    +++++    ++++    ++++++++++++++++    +     +    +
+    +    +                  +            +              +     +    +
+    +    +                  +            +              +     +    +
+    +    +                  +            +              +     +    +
+    +    +                  +            +              +     +    +
+    +    +    +    +++++++++++++++++++++++    +++++++++++     +    +
+    +    +    +    +                 +        +               +    +
+    +    +    +    +                 +        +               +    +
+    +    +    +    +                 +        +               +    +
+    +    +    +    +                 +        +               +    +
+    +    +    +    +    +++++++++    +    +++++     +++++++++++    +
+    +    +    +    +    +       +    +    +         +         +    +
+    +    +    +    +    +       +    +    +         +         +    +
+    +    +    +    +    +       +    +    +         +         +    +
+    +    +    +    +    +       +    +    +         +         +    +
+    +    ++++++    +    +    ++++    +    +    +    +    +    ++++++
+    +         +    +    +    +            +    +    +    +    +    +
+    +         +    +    +    +            +    +    +    +    +    +
+    +         +    +    +    +            +    +    +    +    +    +
+    +         +    +    +    +            +    +    +    +    +    +
++++++    +    +    +    +    +    +++++++++    +    +    +    +    +
+    +    +    +    +    +    +       +    +    +         +    +    +
+    +    +    +    +    +    +       +    +    +         +    +    +
+    +    +    +    +    +    +       +    +    +         +    +    +
+    +    +    +    +    +    +       +    +    +         +    +    +
+    +    +    +    +    +    +    ++++    ++++++    ++++++    +    +
+    +    +         +    +         +       +    +    +              +
+    +    +         +    +         +       +    +    +              +
+    +    +         +    +         +       +    +    +              +
+    +    +         +    +         +       +    +    +              +
+    ++++++    ++++++    +++++++++++    ++++    +    +    ++++++    +
+                   +              +                 +    +    +    +
+                   +              +                 +    +    +    +
+                   +              +                 +    +    +    +
+                   +              +                 +    +    +    +
+    ++++++++++++++++++++++++++    ++++++++++++++    +    +    +    +
+    +    +                   +         +            +    +    +    +
+    +    +                   +         +            +    +    +    +
+    +    +                   +         +            +    +    +    +
+    +    +                   +         +            +    +    +    +
++++++    +    +++++++++++    +    +    +    +++++++++    +    +    +
+         +    +         +         +    +            +    +         +
+         +    +         +         +    +            +    +         +
+         +    +         +         +    +            +    +         +
+         +    +         +         +    +            +    +         +
+++++++++++++++++++++++++++++++++++++++++++++++++++++++++++++++++++++
